{
    "width": 15,
    "height": 13,
    "start": [0,0],
    "goal": [7,12],
    "maze": [
        [0,0,1,0,0,0,0,0,0,0,1,0,0,0,0],
        [0,0,1,1,1,0,1,1,1,0,0,0,0,0,0],
        [0,0,0,0,0,0,1,0,0,0,1,0,0,0,1],
        [0,0,0,0,0,0,0,0,0,0,0,1,1,0,1],
        [0,0,1,0,0,0,0,0,1,0,0,0,0,0,1],
        [0,0,0,0,1,0,0,0,1,0,1,0,1,0,1],
        [0,0,0,0,1,0,0,0,0,0,1,0,1,0,1],
        [0,0,0,0,0,0,0,0,0,0,1,0,1,0,1],
        [0,0,0,0,1,0,1,0,0,0,0,0,1,0,1],
        [0,0,0,0,1,0,0,0,0,0,0,0,0,0,1],
        [0,0,0,0,0,0,0,0,1,0,0,0,1,0,1],
        [0,0,0,0,1,1,1,0,1,1,1,0,0,0,1],
        [1,0,1,0,0,0,0,0,0,0,0,0,1,0,1]
    ]
}