{
    "width": 10,
    "height": 10,
    "start": [0,0],
    "goal": [6,9],
    "maze": [
        [0,1,0,0,0,0,1,0,0,0],
        [0,1,0,0,0,0,1,0,1,0],
        [0,0,0,1,0,0,0,0,1,0],
        [1,1,1,1,0,0,0,0,1,0],
        [0,0,0,0,0,1,0,0,1,0],
        [0,1,1,1,1,1,0,1,1,0],
        [0,0,0,0,0,0,0,0,0,0],
        [0,1,1,1,1,1,1,1,1,0],
        [0,0,0,0,0,0,0,0,0,0],
        [0,0,0,0,0,0,0,0,0,0]
    ]
}